#####################
#0#...#...#...#...#!#
#...#...#...#...#...#
###.#.#.#.#.#.#.#.#.#
#.#.#.#.#.#.#.#.#.#.#
#####################