###################################
#.........#.#.........#.....#...#.#
#.#####.#...##.#####.###.####.#.#.#
#....0#.###....#............###...#
#.#####...###################...#.#
#...#.###..#..#.#.#.........#.###.#
###.#...#.###.......#.###.#.....###
#...#.#.#.#.##.#.#.######.#####..##
#.#.#...#.#....#.....#......!###..#
#...#.#.#.####################.##.#
#.#.....#.........................#
###################################